1 : 2 3 5 ! 4
2 : 1 3 4 5 !
3 : 1 2 4 ! 5
4 : 2 3 ! 1 5
5 : 1 2 ! 3 4